"filename", "language", "SQL", "Java", "Markdown", "comment", "blank", "total"
"c:\Users\Vahe Ohihoin\Desktop\Robotics\Personal Java Projects\HospitalProgram\HospitalManager\src\DataManagingClasses\DatabaseManager.java", "Java", 0, 125, 0, 89, 79, 293
"c:\Users\Vahe Ohihoin\Desktop\Robotics\Personal Java Projects\HospitalProgram\HospitalManager\src\JavaFXTest.java", "Java", 0, 4, 0, 0, 4, 8
"c:\Users\Vahe Ohihoin\Desktop\Robotics\Personal Java Projects\HospitalProgram\HospitalManager\src\Main.java", "Java", 0, 252, 0, 102, 124, 478
"c:\Users\Vahe Ohihoin\Desktop\Robotics\Personal Java Projects\HospitalProgram\HospitalManager\src\TestClass.java", "Java", 0, 18, 0, 0, 13, 31
"c:\Users\Vahe Ohihoin\Desktop\Robotics\Personal Java Projects\HospitalProgram\HospitalManager\src\UtilityClasses\Enums\BloodType.java", "Java", 0, 66, 0, 0, 16, 82
"c:\Users\Vahe Ohihoin\Desktop\Robotics\Personal Java Projects\HospitalProgram\HospitalManager\src\UtilityClasses\Enums\MaritalStatus.java", "Java", 0, 38, 0, 7, 9, 54
"c:\Users\Vahe Ohihoin\Desktop\Robotics\Personal Java Projects\HospitalProgram\HospitalManager\src\UtilityClasses\Enums\Sex.java", "Java", 0, 24, 0, 13, 10, 47
"c:\Users\Vahe Ohihoin\Desktop\Robotics\Personal Java Projects\HospitalProgram\HospitalManager\src\UtilityClasses\Exceptions\InvalidInputException.java", "Java", 0, 7, 0, 5, 6, 18
"c:\Users\Vahe Ohihoin\Desktop\Robotics\Personal Java Projects\HospitalProgram\HospitalManager\src\UtilityClasses\Exceptions\LoadInException.java", "Java", 0, 7, 0, 5, 7, 19
"c:\Users\Vahe Ohihoin\Desktop\Robotics\Personal Java Projects\HospitalProgram\HospitalManager\src\UtilityClasses\Exceptions\PatientNotFoundException.java", "Java", 0, 7, 0, 5, 5, 17
"c:\Users\Vahe Ohihoin\Desktop\Robotics\Personal Java Projects\HospitalProgram\HospitalManager\src\UtilityClasses\General\Date.java", "Java", 0, 278, 0, 37, 108, 423
"c:\Users\Vahe Ohihoin\Desktop\Robotics\Personal Java Projects\HospitalProgram\HospitalManager\src\UtilityClasses\General\DateDifference.java", "Java", 0, 27, 0, 15, 16, 58
"c:\Users\Vahe Ohihoin\Desktop\Robotics\Personal Java Projects\HospitalProgram\HospitalManager\src\UtilityClasses\General\Patient.java", "Java", 0, 170, 0, 137, 117, 424
"c:\Users\Vahe Ohihoin\Desktop\Robotics\Personal Java Projects\HospitalProgram\HospitalProgramSQLFiles\CreatingTestDatabase.sql", "SQL", 13, 0, 0, 0, 4, 17
"c:\Users\Vahe Ohihoin\Desktop\Robotics\Personal Java Projects\HospitalProgram\HospitalProgramSQLFiles\DatabaseEdits.sql", "SQL", 59, 0, 0, 0, 38, 97
"c:\Users\Vahe Ohihoin\Desktop\Robotics\Personal Java Projects\HospitalProgram\README.md", "Markdown", 0, 0, 2, 0, 1, 3
"Total", "-", 72, 1023, 2, 415, 557, 2069