"filename", "language", "Markdown", "SQL", "Java", "comment", "blank", "total"
"c:\Users\Vahe Ohihoin\Desktop\Robotics\Personal Java Projects\HospitalProgram\HospitalManager\src\DatabaseClasses\DatabaseManager.java", "Java", 0, 0, 57, 28, 31, 116
"c:\Users\Vahe Ohihoin\Desktop\Robotics\Personal Java Projects\HospitalProgram\HospitalManager\src\Main.java", "Java", 0, 0, 107, 13, 46, 166
"c:\Users\Vahe Ohihoin\Desktop\Robotics\Personal Java Projects\HospitalProgram\HospitalManager\src\TestClass.java", "Java", 0, 0, 16, 0, 11, 27
"c:\Users\Vahe Ohihoin\Desktop\Robotics\Personal Java Projects\HospitalProgram\HospitalManager\src\UtilityClasses\Enums\BloodType.java", "Java", 0, 0, 66, 0, 16, 82
"c:\Users\Vahe Ohihoin\Desktop\Robotics\Personal Java Projects\HospitalProgram\HospitalManager\src\UtilityClasses\Enums\MaritalStatus.java", "Java", 0, 0, 38, 7, 9, 54
"c:\Users\Vahe Ohihoin\Desktop\Robotics\Personal Java Projects\HospitalProgram\HospitalManager\src\UtilityClasses\General\Date.java", "Java", 0, 0, 271, 27, 106, 404
"c:\Users\Vahe Ohihoin\Desktop\Robotics\Personal Java Projects\HospitalProgram\HospitalManager\src\UtilityClasses\General\DateDifference.java", "Java", 0, 0, 27, 13, 16, 56
"c:\Users\Vahe Ohihoin\Desktop\Robotics\Personal Java Projects\HospitalProgram\HospitalManager\src\UtilityClasses\General\Patient.java", "Java", 0, 0, 138, 63, 97, 298
"c:\Users\Vahe Ohihoin\Desktop\Robotics\Personal Java Projects\HospitalProgram\HospitalProgramSQLFiles\CreatingTestDatabase.sql", "SQL", 0, 13, 0, 0, 4, 17
"c:\Users\Vahe Ohihoin\Desktop\Robotics\Personal Java Projects\HospitalProgram\README.md", "Markdown", 2, 0, 0, 0, 1, 3
"Total", "-", 2, 13, 720, 151, 337, 1223